1 1 1 1 1 1 1 1 1 1 1 1 1 1 1 1 1 1 1 1 1 1 1 1 1 1 1 1 1 1 1 1 1 1 1 1 1 1 1 1 
1 1 1 1 1 1 1 1 1 1 1 1 1 1 1 1 1 1 1 1 1 1 1 1 1 1 1 1 1 1 1 1 1 1 1 1 1 1 1 1 
1 1 1 1 1 1 1 1 1 1 1 1 1 1 1 1 1 1 1 1 1 1 1 1 1 1 1 1 1 1 1 1 1 1 1 1 1 1 1 1 
1 1 1 1 1 1 1 1 1 1 1 1 1 1 1 1 1 1 1 1 1 1 1 1 1 1 1 1 1 1 1 1 1 1 1 1 1 1 1 1 
1 1 1 1 1 1 1 1 1 1 1 1 1 1 1 1 1 1 1 1 9 1 1 1 1 1 1 1 1 1 1 1 1 1 1 1 1 1 1 1 
1 1 1 1 1 1 1 1 1 1 1 1 1 1 1 1 1 1 1 9 8 9 1 1 1 1 1 1 1 1 9 1 1 1 1 1 1 1 1 1 
1 1 1 1 1 1 1 1 1 1 1 1 1 1 1 1 1 1 1 9 8 9 1 1 1 1 1 1 1 9 8 9 1 1 1 1 1 1 1 1 
1 1 1 1 9 1 1 1 1 1 1 1 1 1 1 1 1 1 1 9 8 9 1 1 1 1 1 1 1 9 8 9 1 1 1 1 1 1 1 1 
1 1 1 9 8 9 1 1 1 1 1 1 1 1 1 1 1 1 1 1 8 1 1 1 1 1 1 1 9 9 8 9 9 1 1 1 1 1 1 1 
1 1 1 9 8 9 1 1 1 1 1 1 1 1 1 1 1 1 1 1 8 1 1 1 1 1 1 1 9 9 8 9 9 1 1 1 1 1 1 1 
1 1 9 9 8 9 9 1 1 1 1 1 1 1 1 1 1 1 1 6 6 6 6 1 1 1 1 1 1 1 8 1 1 1 1 1 1 1 1 1 
1 1 9 9 8 9 9 1 1 1 1 1 1 1 1 1 1 1 5 5 5 5 5 5 1 1 1 1 1 1 8 1 1 1 1 1 1 1 1 1 
1 6 6 1 8 1 1 1 1 1 1 1 1 1 1 1 1 1 5 5 5 5 5 5 1 1 1 1 1 1 8 1 1 1 1 1 1 1 1 6 
6 5 5 6 8 1 1 1 1 1 1 1 1 1 1 1 1 1 1 7 7 7 7 1 1 1 1 1 1 1 6 6 1 1 1 6 6 6 6 5 
5 5 5 5 6 6 1 1 1 1 1 6 1 1 1 1 1 1 1 7 7 7 7 1 1 1 1 6 6 6 5 5 6 6 6 5 5 5 5 5 
5 7 7 5 5 5 6 6 6 6 6 5 6 6 6 1 1 1 1 1 7 7 1 1 1 1 6 5 5 5 5 5 5 5 5 5 5 5 5 7 
7 7 7 7 5 5 5 5 5 5 5 5 5 5 5 6 6 6 1 1 1 1 1 1 1 6 5 5 5 5 7 7 5 5 5 7 7 7 7 7 
7 7 7 7 7 7 5 5 5 5 5 7 5 5 5 5 5 5 1 1 1 1 1 1 6 5 10 7 7 7 7 10 10 7 7 7 7 10 10 7 
7 7 7 7 7 7 7 7 7 7 7 7 7 7 7 10 10 1 1 1 1 1 1 6 10 10 7 7 7 7 10 10 7 7 7 10 7 7 7 7 
7 7 7 7 7 7 7 7 7 7 7 7 7 7 10 10 10 1 1 1 1 1 1 6 10 10 7 7 7 7 7 7 7 7 7 7 7 7 7 7 
